Team: 11
Map: 40
Unit Length: 40
Unit: cm
Origin: (1,4)
Notes: This is an example map
0,0,0,0,0,0,0,0,0
0,0,0,0,0,0,0,0,0
0,0,1,1,1,1,1,0,0
0,0,0,0,0,0,1,0,0
0,0,0,0,1,1,1,0,0
0,0,0,0,5,0,0,0,0
0,0,0,0,4,0,0,0,0
