Team: 11
Map: 40
Unit Length: 40
Unit: cm
Origin: (1,4)
Notes: This is an example map
0,0,0,0,0,0,0,0,0
0,0,0,0,0,0,1,0,0
0,1,2,2,2,2,2,0,0
0,0,1,0,0,0,2,0,0
0,0,1,0,2,2,2,1,0
0,0,1,0,3,0,0,0,0
0,0,0,0,6,0,0,0,0
